bre1	ChromatinModifer
bur2	TranscriptionElongation
bye1	TranscriptionElongation
cac1	ChromatinRemodeler
cac2	ChromatinRemodeler
cac3	ChromatinRemodeler
cbc1	RNAprocessing
ccr4	TranscriptionElongation
cdc39	TranscriptionElongation
cdc73	TranscriptionElongation
chd1	ChromatinRemodeler
ctr9	TranscriptionElongation
dhh1	TranscriptionElongation
dst1	TranscriptionElongation
eaf1	ChromatinModifer
elf1	TranscriptionElongation
gcn5	ChromatinModifer
hda1	ChromatinModifer
hpc2	ChromatinRemodeler
htz1	HistoneVariant
ino80	ChromatinRemodeler
isw1	ChromatinRemodeler
isw2	ChromatinRemodeler
leo1	TranscriptionElongation
nap1	ChromatinRemodeler
npl3	RNAprocessing
paf1	TranscriptionElongation
rad6	ChromatinModifer
rai1	RNAprocessing
rco1	ChromatinModifer
rpb4	TranscriptionElongation
rph1	ChromatinModifer
rsc30	ChromatinRemodeler
rtf1	TranscriptionElongation
rtt103	TranscriptionElongation
set2	ChromatinModifer
set3	ChromatinModifer
spt4	TranscriptionElongation
swr1	ChromatinRemodeler
ubp8	TranscriptionElongation
vps15	TranscriptionElongation
vps34	TranscriptionElongation
wt	Wildtype
